111111
1P00001
1C0C0E1
1C00001
111111
